2 2 2 2 2 2 2 2 2 2
2 1 3 0 0 0 0 0 4 2
2 0 3 0 0 0 0 0 4 2
2 0 0 0 0 0 0 3 4 2
2 0 0 0 3 4 0 3 4 2
2 0 0 0 3 4 0 3 4 2
2 0 0 0 0 0 0 3 4 2
2 0 0 3 0 0 0 3 4 2
2 0 0 0 0 0 0 0 4 2
2 2 2 2 2 2 2 2 2 2